WE ../textures/north.xpm
NO ../textures/south.xpm
SO ../textures/west.xpm
EA ../textures/east.xpm

F 24,100,25
C 255,239,185


111111111111111111111111
100000000000000010000001
100000001111111110000001
10N001000000000000011111
101100000000000010000001
100001000001111110000001
100001000000000000000001
111111111111111111111111
