NO ../textures/BlueWall.xpm
SO ../textures/BrownWall.xpm
WE ../textures/GrayBrick.xpm
EA ../textures/RedWall.xpm

F 34,139,34
C 55,198,255

111111111111111
100101010010001
100000010101001
101000000010001
101000111000001
101011100000001
101000100111111
101000100100001
101000100100001
101000100100001
101000100100001
101000100100N01
101111111100001
100000000000001
111111111111111
